111111111111111111111111
10C0000C01000C0001000011
11000C0001C00000C1000011
11C01110P100C011110C0011
11000C00010C000000000011
11C0000C010000C000000011
11000C000000C0000000C011
10C000000C00000C00000E11
111111111111111111111111
